NO ./path_to_the_north_texture.xpm
SO ./path_to_the_south_texture.xpm
WE ./path_to_the_west_texture.xpm
EA ./path_to_the_east_texture.xpm
F 226,100,0
C 255,30,0

1111111111111111111111111
    100000000001111111
1111111111111111111111111