NO file.xpm
SO file.xpm
WE file.xpm
EA file.xpm
F 220,100,0
C 225,30,0
111111111111111111111111
1010000000110000000000001
1N11000001110000000000001
1111111111111111111111111
1001000000000000000000001
1111111110110000011100001
111111111111111111111111111
