NO file.xpm
SO file.xpm
WE file.xpm
EA file.xpm
F 220,100,0
C 225,30,0



111111111111111111111111
1010000000110000000000001
1111000001110000000000001
111111111111111111111111111111111111111111111111111111111111111111111111111111111111111111111111111111111111111111111111111111111111111111111111111111111111111111
10010000000000N0000000001
1111111110110000011100001
111111111111111111111111111
111111111111111111111111111111111111111111111111111111111111111111111111111111111111111111111111111111111111111111111111111111111111111111111111111111111111111111111111111111111